NO textures/dsa.xpm
SO textures/dsa.xpm
WE textures/dsa.xpm
EA textures/dsa.xpm

F 123,20,123
C 153,204,100

  1111111111111111111111111
  1000000000110000000000001
  1011000001110000000000001
  1001000000000000000000001
11111111111111111011100000011
10000000001100000111011111111
11110111111111011100000010001
11110111111111011101010010001
11000000110101011100000010001
10000000000000001100000010001
10000000000000001101010010001
11000001110101011111000010N01
11110111 1110101 101111010001
11111111 1111111 111111111111
