SO textures/SOUTH.xpm
WE textures/WEST.xpm
EA textures/EAST.xpm
NO textures/NORTH.xpm

F 0,0,0
C 153,204,100

  1111111111111111111111111		
  1000000000110000000000001
  1011000001110000000000001
  10010000000000000000000011
111111101111111100110000000111111
100000000011000001110111111111111
11110111111111011100000010N010
111101111111110111010100100010
110000001101010111000000100010
100000000000000011000000000010
100000000000000011010100100010
1100000111010101111101111000111
11110111 1110101 101111010001
11111111 1111111 111111111111
