SO textures/SOUTH.xpm
WE textures/WEST.xpm
EA textures/EAST.xpm
NO textures/NORTH.xpm

F 0,0,0
C 153,204,100

11111111111111
10000000000001
10000001110001
10000001E00001111111111111111111111111111111111111111111111111111111111111111111111111111111111111111111111111111111111111111111111111111111111111111111111111111111111111111111111111111111111111111
10000000000000000000000000000000000000000000000000000000000000000000000000000000000000000000000000000000111111111111111111111111111111111111111111111111111111111111111111111111111111111111111111111
10000000000001111111111111111111111111111111111111111111111111111111111111111111111111111111111111111111111111111111111111111111111111111111111111111111111111111111111111111111111111111111111111111
11111111111111

