NO textures/NORTH.xpm
SO textures/SOUTH.xpm
WE textures/WEST.xpm
EA textures/EAST.xpm

F 123,20,123
C 153,204,100

11111111
10000001
10000001
1000E001
10000001
10000001
11111111