SO textures/SOUTH.xpm
WE textures/WEST.xpm
EA textures/EAST.xpm
NO textures/NORTH.xpm

C 1,100,73
F 100,10,40

111111111
100000001
100000001
100000001
100010001
100000001
10E000001
100000001
111111111

