NO textures/dsa.xpm
SO textures/dsa.xpm
WE textures/dsa.xpm
EA textures/dsa.xpm

F 123,20,123
C 153,204,100

111111111111111111111
10N1
1111
