NO textures/wall.xpm
SO textures/wall.xpm
WE textures/wall.xpm
EA textures/wall.xpm

F 123,20,123
C 153,204,100

111111111111111111111
100000000000000000001
100000000000000000001
111111100000111011101
111111100000111011101
111111100000111011101
111111100000111011101
111111100000111011101
111111100000111011101
100000000000000000001
100000000000111011101
100000N00000000000001
100000100000000000001
100000000000000000001
100000000000000000001
100000000000000000001
100000000000000000001
100000000000000000001
100000000000000000001
111111111111111111111
