NO textures/dsa.xpm
SO textures/dsa.xpm
WE textures/dsa.xpm
EA textures/dsa.xpm

F 123,20,123
C 153,204,100

0000000000000000000000
1111111111111111111110
1010000010000000000010
1010101010111111100010
1000101000100000100010
1111101011111010111010
1000001010001010000010
1011111010111011111110
1010000010101000001010
1010111110101111101010
1010100010101000101010
1011101010101010101010
1000001010100010100010
1111111010111110111010
1000001010001000100010
1011101011101011101110
1010001000001000101010
1010111100011110101010
100010000N000000100010
1010101100011111111010
1010000010000000000010
1111111111111111111110
0000000000000000000000
