NO textures/NORTH.xpm
SO textures/SOUTH.xpm
WE textures/WEST.xpm
EA textures/EAST.xpm

F 123,0,0
C 100,10,200

111111111111111111111
100000000000000000001
100000000000000000001
100000000000000000001
100000000000000000001
100000000000000000001
10000000000000000000111111111111
100000000000000000000000000001001
10N00000000000000000111111111111
100000000000000000001
100000001111111111111
100000000000000000001
100000000000000000001
100000001111111111111
100000001
100000001111111111111
100000000000000000001
100000000000000000001
101000001000000000001
111111111111111111111
